bitorder = ABCD RSHG  TFKE NMUP

A = ABCDGHUP
B = ABCDEFPMS
C = ABEFGH
D = ABCDEFMS
E = ABEFGHUP
F = ABGHUP
G = ABDEFGHP
H = CDGHUP
I = ABEFMS
J = CDEFG
K = GHUNR
L = EFGH
M = CDGHKN
N = CDGHKR
O = ABCDEFGH
P = ABCGHUP
Q = ABCDEFGHR
R = ABCGHUPR
S = ABHUPDEF
T = ABMS
U = CDEFGH
V = CDKR
W = CDGHTR
X = KNRT
Y = KNS
Z = ABNTFE

a = ABCDEFGUP
b = HGFEDPU
c = EFGUP
d = CDEFGUP
e = EFGHABCPU
f = SMBUP
g = ABCDEHUP
h = HGUPD
i = SA
j = CDE
k = HGUPR
l = MSE
m = GUPDS
n = GUPD
o = DEFGUP
p = GHABNU
q = ABCDKP
r = GU
s = PREF
t = UPMSE
u = DEFG
v = RD
w = GTRD
x = KNRT
y = HUPCDEF
z = UTFE

0 = ABCDEFGHNT
1 = CD
2 = ABCPUGFE
3 = ABCDEFPU
4 = HUPCD
5 = BAHUPDEF
6 = BAHGFEDUP
7 = ABCD
8 = ABCDEFGHUP
9 = ABCDEFHUP

_ = FE
- = UP
+ = MSUP
* = MSUPKNTR
( = AFGH
) = BCDE
[ = AFGH
] = BCDE
| = HG
\ = KR
/ = TN
< = NR
> = KT
` = K
' = N
" = HC
, = R
= = ABUP
% = AHUMNTPDSE